21
.......o.o........o..o...o..o.o.oo..o...oo.o..o..o...o.o......o..o.o.............oo...o..........
..............oo.oo...o...............o..o..oo..o.o..................o.o...o.o....o.o.o.o...o...o
......o...o.....o.......o.oo.o..o..oo.........o.o..o.o....oo.o.o.......o.oo.o....o..o.....o.....o
..o..o..o.......o...o..o..o...o...oo.........o...o.o.o....o....o......o.o..o.o.o.o.....o.o.......
.....o...oo.o....o..o.oo...........o.o......oo..oo...o....o..o..o.......o..o............oo....o..
..oooo..o....o......o..ooooo..o.....oo.o.....o..o........o...o.o..o.oo....o.o.o.oo...o.....o..o..
.......o....o.........o....o...o.o..ooo.o.......o.o.......o..o......o........o...o.o...o..ooo...o
......oooooo....oo........o..o..oo.o......o..oo..........o...o...o...o.ooo....ooo...oo.o...o.o...
..o......oo.....o...oo..o....o......oooo.o...oo......o...o.o...o...oo.......o...o.o...........o..
.........o...o.......o....o....o.ooo...o....o....o....o..oo.....o...o......o....o.....o.....o....
.oo....o.....o...........o...o.o.o......oo.o...o..o.o......oo.o.......o......o..o..o....o...o.o.o
o..o..o...o.o...oo..........o.o.o....o.o..o...oo.................o..oo.o..o..o.......o..o....o.o.
..o.oo..........ooo..............o.o....o.ooo.............o.o......oo...o.ooo....o.o.o.o...o..ooo
o..oo.o.o....o...o...oo.o..o......oo.o......o...o......o....oo...o.o....o.ooooo......o.o....o..oo
.....oo........o......o.oo.....oo....ooo.o.o..o.o..o.o..o.o...o.....o..............ooo...........
.o..ooo......oo..............o.....o...oo..ooo.o......o................o.....o.o.....o..o...o.oo.
oo..o.......o..o....o.oo...o.o..........oo...ooo..o....o.......oo..o.o..oo.ooo...o.........oo....
.....o....o....o..o.o...o.....o....o...........oo.....................o..oo..o.....oo..o....oooo.
.o.......o....o............o.....oooo.o.oo.o....o..................oo...............o....o.o.....
o...o.oo...........o...oo......o..o...o...o..o......ooo........o...o...........o.o.o.o...........
.ooo.o......o....o.........oo..o.....o....oo...o..o..o......oooo.oo...o...........o......o....o..
