137
o....o.o...o.o....o....o..o..o.o..
...ooo..o..o.o.....oo..o.....ooo.o
.o.....o.o.....o..oo......o.....oo
o...o..o..o........o.......o......
.....o.o...o....oo...o...ooo.oo...
.o...o....o......oo.....o.o...o...
o.o....o.o...................o....
..........o.o......o....o..o....o.
o....oo.o.......o....o..oooo......
o....oo.......o..o.o.......o.o.oo.
.o.ooo........o..o....o.oooo..o.o.
.......o....o.......o.....oo....o.
....o.o....o.....o..o.o.o.o.....o.
o.o...o......oo......o.....o..o...
.o...o............................
....o....ooo.o.o.oo.........o.o...
.o....o.o..o.o...oo..o............
.o...o.oo..o........oo.....oo.o...
..o..o....o...........oo..o..o....
...o...o......o......o...o......o.
ooo......oo.....o...o..o...o......
..o..............o...o..........o.
o......o..o........o..o.ooo......o
.o...o.....o..oo...o.o..oo........
o.....o....oo...oo....o.......o..o
.o.o....o.oo...........o.......o.o
......o.oo.......oo.o....o.o.o....
........o...ooooo...o.....oo......
.........o..o.......o..o..o....o..
.o......o.o.oo.........o...o......
o............o............o..o....
...o..oo..o.o...........o.........
......o.ooo..oo.oo.............oo.
o..oo.o....o...o....o.o..........o
.o.......ooo..ooo.................
.o.ooo...o...o.o.o.o.....o.o.o....
.o..o....o....oo....o......o..o...
......o.o...o..........o...o..o.o.
o...o..o....oooo..o..o..o...oo...o
o....o.......o...o..oo..oo.o.o....
..........o...o...........o..o....
.......o....o..o..o..o.o.......o.o
o..o.o....o..o.ooo........o.ooo...
....o...o.o...oo..o...o..o....o...
....o.oo...oo.oooo...o.o....o..oo.
oo.oooo.....o.......ooo.o.....o...
o..o.o..o..o.o.o.......o...o..oo..
o..o..o.....o..o.....oo..o...o.o.o
......oo...........o....oo......oo
o....oo...ooo.o......o..oo..o.....
o.......o..o...o.o.o......o.o....o
.........o........oo.........o....
..o..o..o..........o....oo.....o.o
o.....o.ooo....o...ooo.......o....
...o.......o...o..o.o.o......ooo..
..o...o...o...o.o...........o.o.o.
o...o.....oo.o..o......o.o....oo..
o...o...o.oooo....oo........o.....
.......o...o.o.....o..o....oo.....
o.....o.o...o.o...o.......oo.....o
..o.o.o.o.ooo......o..oo.........o
.o..o....o..o................o....
....o.....oo....o....o...o..o.....
oo...o..o.o.o..........ooooo......
.....o......o.o...ooo.o..o.ooo....
............oo....o.o..........o..
o..o...oo........o......o...oo..o.
.o..o..............o......o.oo..oo
...ooo....ooo..o.oo....o.....o....
.o.....o.....o.o...o.o.o...o..oo.o
......o.o....oo.........o...o.....
....o.......o....o..o.oo..o......o
oo.ooooo..oo..oo...o...oo.....o.o.
..o...oooo.o..o.o..o.o.o.o........
..o.o.o.....oo.............o......
.........oo.....o..o..........o...
..o.......o....o.....o.o..o....oo.
o....ooo......oo.....o..o..o..oo..
...o.o.....o.ooo...o.o.........oo.
..o..........o.....o.....o.ooo.o..
o...o...o.o.ooo.oo.o...o.o..o...o.
.o.ooo.o................o....o...o
....o..o..o.......oo.........o....
...........ooo...oo..o....o.o.....
..o...ooooo........oo.o...oo.o...o
........o..o......o..o..oo.....oo.
..o....ooo.oo.ooo.o....o.........o
............oo...o.....o..o....o..
..ooo........o.o......o......o....
....oooo.o.....oo......o....o.oooo
.....o.oo.....o.......o....o.....o
........oo.oo.o.o..o....o......oo.
o...........o..o..........o....oo.
......oo...o......o...o....o....o.
..o....o.oo.......o.o.oo......o...
..o..o......oo.o........o...oo.o..
.....o.oo......ooo.o.o..o.o...o.oo
...o...o.oo..oo.....o......o.....o
.................o...........o....
oo.......o........o........o.oo.oo
..............o..........oo..o....
oo..oo.o.......o.o..oo..o..o..o...
........o..oo.o......o.....o...o..
.........o..................o...o.
...o....o..o....oo......oo.....oo.
o........o.o......o...o.......o...
...o...o.o.oo.oo..o.......o..o...o
.............o...o...oo...o.oo.o..
.o..o.o....o.....o...o...o..o...o.
..o.....oo..o...ooo..o....o..o....
o..ooo.o....o..........o....o.o...
.oo....o.oo.o...o.o..o....oo....oo
o..o.oo.oo..o.o.o..o..oo..o...o.o.
......o..o...o.o..o..o..o.o.o.....
....oo..o......o.....oo...o.....oo
o...o...ooo..o...oo.o....o.o...ooo
.o.o..o.........o...o.o...o.ooo...
......o...oo...o..o...o......o..oo
..o.o...oo.o.............o.o...oo.
............o..o.o.....ooo.o.o....
....o.....o.oo.......oo..........o
o..o......o.......o.oo..o.oo.o..o.
o..o.....o..o.......o.oo.o.o.o.oo.
...o......o.o....o..o.....oooooo.o
.............o...o....oo...o....oo
o.......ooooo...o.oo.....o...o.o..
...ooo.o...oooo...o......o.....o.o
o...ooo...oo.o......o........o.o.o
.ooo...oo...o....o....oo..ooo..o..
.o.o.....o.................o..o...
....oo..o......o..oo.........oo...
....o......o......o............o..
...o.o.o...ooooo...o....o.........
oo.....oo..oo.oo........o..ooo....
o............o....o....o.oo....o..
o..ooo......o........o.oo.......o.
..o......o..o..o.............o..o.
