50
o...o.o.o..oo..........o......o.....ooo.........oo
oo....ooo.......o.oo.o..oo...o..o....o.o.o....oo.o
oo....oo.............o...o..o....o.o..........o..o
o......o.........o....o..o..oooo.oo.oo....oo....oo
o..o..o......o.o........oo....oo...o.........ooo.o
o..o....o..o.oo.....oo..oo...........o...o.......o
oo..o.o....ooo.o.....o.............oo.oo.o..o..o.o
o...oo...o...o.................o.....oo..oo.oo...o
ooo..oo........o..o.o..o............o...o........o
o.o.....oo......o..o..o....o.oo.o.....oo.........o
o....oooo.oo......o.....o.o.o..o.o.oo.ooo........o
o....o.....o.oo..ooo..o..o.o.o....o.......o......o
o....o.oo.oo..oo.........o..o.....o........o.....o
o.......o......o...o....o...o.o..o..oo....o.....oo
o.o...o.........o........oo....o......o..o..o....o
oo...oo.o.....o...o.........o......o..oo.o.o.oo..o
o.........o.oo....o.......o..oo.o...o...o......o.o
ooooo.....o..oo.oo.oo.oo.o.......o...o.o....ooo..o
o.o.....o...........oo.......oo..o..oo....oo.....o
oo.o.....oo...o..ooo.........o.o.oo......o...o...o
oo.....o....o.o.o.o..........o....o...o......o..oo
o..........o.o.....o....o..oo.....o..o..o........o
o.o...o.o....o.o..o.......o..ooo...o.....o.......o
o..o.........o..o...o.................o.o.....o..o
o....o.o....o.oo.o............o..o.....o.o...o...o
o........o...o..oo..o..oo..o....o..o.o...o...o...o
o.................o.........o..o..o..oo.o...o...oo
o....o......o.......o...oo.....o.o.....o.o...o.ooo
o.o........o.o...........o...o...o.......o....o..o
oo......o....o.......o......o.....o.o....o.o..o..o
o.....o....oo......ooo...o.o....ooo..........o...o
o....o.......o..o.o..oo....o......oo......oo.....o
oo...oo......o...o.........o........o...........oo
o......o.o.........o......o............o..o..o...o
ooooo.....ooo...o...oo.....oo.....o.oo...o..o....o
o..o........o......oo..o.....o.....oo.o..o.o..o..o
o..o.o........o..o.....o..oo.o....oo.......o.oo.oo
oo.o.o..o......o....o....o..o.ooo..o..oo.o..o....o
o.oo......o...o...o.....o..........o.o.o....o....o
oo..o.......o.oo........o..o...o.oo......o.oo...oo
o....o..o........o........oo...oo.....oo..o......o
o..o...o.....o...o...oo...o.............o.....o..o
o....o.o..ooo..ooo....o.ooo.o....o.o..o.......o..o
o..o.......oo......o..o....o...........o.o.......o
oo.....................o..o...o.o....o.o.o......oo
o............o.......o..oo..o..o..ooo.....o......o
o...oo.o.o..o..oo..........o....o.....oo...o.o...o
o.....oo...o....o....oo...o.o..oo..o..o..oo.oo...o
o.o.o.oooo...o...o....oo......o...o...o..o...o...o
oooo............oo.o.o..o....o.o....o..o.o....o.oo
