50
..o...o.....o...o...o.............oo.o..........o.
.oo...o.o..o...o....ooo.oo....o.ooo...oo...o.o..o.
.....oo..o..oo..o...oo....ooo....oo.....o.........
....o.......oo.....o.o......o....oo......o....o.o.
.oo......o..o..o......o......o..o...o..o.o........
......o..............oo.........oo...o....o.o..o..
........oo........o..................o....o....o..
..o.o......o.o......oo.o..oo..o....o..o......o....
.....o...o....o.......o..........o.o.o............
......o.....oo.o.........o.oo.....o..o.o.......oo.
.oo..oo....o......o...o....o.......oo..........o..
.o..o....o.......o...o........o.......o.....oo....
..ooo..o...o....o...o.o..o..o.oo.....o....o.o.ooo.
.......oo.................o......oo....o.o..o.....
..o.o....o........................o..oo...o..o....
.o...ooo....o.........o....o.o..o........oo....o..
......o......o...o.ooo...o.o.....o.......o.o..o.o.
...oo.....o.o........o..o......oo..ooooo..o.......
.o..oooo........o.o.....o.....oo......oo.......o..
.....o.....oo...o...o.o..............oo....oo...o.
..oo..oo..o......oo.....o...oo...o....o.....o.....
...ooo.......o.....o.....o......o.....o.o.........
......o.........o.o.....o.....o..ooo.o.o..........
...o..o.o.o....o.o..o...oo.........o.........o..o.
.o..ooo......o...oo.o.o....................o....o.
..............oo.oo..........oo........o....o.....
..o......o.........oo..o.....o..........o....o....
...............ooo.....ooooo..o.o..o......o.......
.........o..o..o......oo..oo...o.o...o.o.......oo.
.o.oo..o......o.o..oo......oo....oo...o...........
..o...o.o..........o.o.....o.....o......o...o..o..
.o...........ooo.o.......o....o.....o..o...oo.....
.....o.o....o....oo...o....o...........o..o....o..
..........o...o......o.o.......o...o...oo.o...o...
...ooo..o..oo.......oo......oo.o.o..o.....ooo...o.
.ooo....o.......o...o.....o.oo.o....o..o....o.o...
.oo.o.o...o..oo......ooo....o....o....o.........o.
.oo.o.....o.o..o......o.....o....o..ooo......o..o.
........o..oo..o...o...oo.o....oo....oo.o.o.....o.
.....o....o..........o......o.....o.o.....o.......
........o.....oo...o..o.......oo.o.....o........o.
.........o.oo......o...o.o....o.o.....o...o..o....
................o....o.o........o..........o...oo.
......o.oooo....oo.o......o........ooo.oo...o.....
...o...oo.oo....o.o.....oo.o..o...o.....oo.o....o.
..ooo.oo.o...o........o.o.o.o.....o.ooooo.......o.
..o....ooo...o..o.......o.o.o....o...o.o.......o..
..o...........o......oo...o....o.o..........o.oo..
..oo.......o...o...o.o.o.............oooo......o..
....oo...o....o..o.o...o....o...oo.o....ooo.......
